
5	63
32	32
0	1	2	3	4	5	6	6	7	8	6	9	6	9	7	8	6	6	7	8	6	6	10	4	5	7	8	6	7	8	1	2	11	12	2	6	6	7	8	6	6	7	8	6	6	13	14	15	6	6	6	6	16	17	6	7	8	9	18	17	6	6	7	
19	20	21	22	22	23	17	24	25	26	27	28	29	30	31	6	18	17	6	9	6	6	32	22	33	13	14	14	14	15	20	34	21	35	21	23	17	13	15	13	14	14	36	17	13	37	38	39	7	40	25	29	28	41	42	43	29	30	31	7	8	6	6	
44	45	46	47	48	49	50	51	52	52	53	54	53	54	55	56	57	58	59	60	61	62	63	48	64	37	38	65	65	66	45	67	46	68	69	49	70	71	72	73	38	65	74	75	37	76	77	78	50	51	52	53	54	53	54	52	53	54	55	57	58	79	80	
81	82	82	82	82	82	82	82	82	82	82	82	82	82	82	82	83	84	85	84	85	84	85	84	86	76	77	87	87	88	89	84	90	85	89	91	82	92	93	92	94	95	96	97	76	98	77	88	89	84	99	84	99	84	99	89	91	82	82	82	82	82	82	
100	101	101	101	101	101	101	101	101	101	101	101	101	101	101	101	102	103	104	103	104	103	104	103	105	106	107	108	108	109	110	103	111	112	113	114	101	101	101	101	101	101	101	115	106	106	107	109	110	103	116	103	116	103	116	113	114	101	101	101	101	101	101	
